0 0 0 0 0 0 0 0 0 0 0 0 0 0 0 0
0 0 0 0 0 0 0 0 0 0 0 0 0 0 0 0
0 0 0 0 0 0 0 0 0 0 0 0 0 0 0 0
0 0 0 0 0 0 0 0 0 0 0 0 0 0 0 0
0 0 0 0 0 2 2 2 2 2 2 2 2 0 0 0
0 0 0 0 0 2 1 1 1 2 4 1 2 0 0 0
0 0 0 0 2 2 1 1 3 4 4 4 2 0 0 0
0 0 0 0 2 1 1 3 1 2 6 4 2 0 0 0
0 0 0 2 2 1 2 2 3 2 1 2 2 0 0 0
0 0 0 2 1 1 1 3 1 1 3 1 2 0 0 0
0 0 0 2 1 1 1 2 1 1 1 1 2 0 0 0
0 0 0 2 2 2 2 2 2 2 5 1 2 0 0 0
0 0 0 0 0 0 0 0 0 2 2 2 2 0 0 0
0 0 0 0 0 0 0 0 0 0 0 0 0 0 0 0
0 0 0 0 0 0 0 0 0 0 0 0 0 0 0 0
0 0 0 0 0 0 0 0 0 0 0 0 0 0 0 0
