0 0 0 0 0 0 0 0 0 0 0 0 0 0 0 0
0 0 0 0 0 0 0 0 0 0 0 0 0 0 0 0
0 0 0 0 0 0 0 0 0 0 0 0 0 0 0 0
0 0 0 0 0 0 0 0 0 0 0 0 0 0 0 0
0 0 0 0 2 2 2 2 2 2 2 2 2 2 0 0
0 0 2 2 2 1 1 1 4 1 1 1 1 2 0 0
0 0 2 1 1 1 2 2 3 2 2 1 1 2 0 0
0 0 2 1 1 3 4 1 4 1 4 3 2 2 0 0
0 0 2 2 5 3 2 2 3 2 2 1 2 0 0 0
0 0 0 2 1 1 1 1 4 1 1 1 2 0 0 0
0 0 0 2 2 2 2 2 2 2 2 2 2 0 0 0
0 0 0 0 0 0 0 0 0 0 0 0 0 0 0 0
0 0 0 0 0 0 0 0 0 0 0 0 0 0 0 0
0 0 0 0 0 0 0 0 0 0 0 0 0 0 0 0
0 0 0 0 0 0 0 0 0 0 0 0 0 0 0 0
0 0 0 0 0 0 0 0 0 0 0 0 0 0 0 0
