0 0 0 0 0 0 0 0 0 0 0 0 0 0 0 0
0 0 0 0 0 0 0 0 0 0 0 0 0 0 0 0
0 0 0 0 0 0 0 0 0 0 0 0 0 0 0 0
0 0 0 0 0 0 0 0 0 0 0 0 0 0 0 0
0 0 0 0 0 0 2 2 2 2 0 0 0 0 0 0
0 0 0 0 0 0 2 1 1 2 0 0 0 0 0 0
0 0 0 0 2 2 2 1 1 2 2 2 2 0 0 0
0 0 0 0 2 1 1 4 6 1 1 1 2 0 0 0
0 0 0 0 2 5 3 4 4 1 3 1 2 0 0 0
0 0 0 0 2 2 2 1 3 2 2 2 2 0 0 0
0 0 0 0 0 0 2 1 1 2 0 0 0 0 0 0
0 0 0 0 0 0 2 2 2 2 0 0 0 0 0 0
0 0 0 0 0 0 0 0 0 0 0 0 0 0 0 0
0 0 0 0 0 0 0 0 0 0 0 0 0 0 0 0
0 0 0 0 0 0 0 0 0 0 0 0 0 0 0 0
0 0 0 0 0 0 0 0 0 0 0 0 0 0 0 0
