0 0 0 0 0 0 0 0 0 0 0 0 0 0 0 0
0 0 0 0 0 0 0 0 0 0 0 0 0 0 0 0
0 0 0 0 0 0 0 0 0 0 0 0 0 0 0 0
0 0 0 0 0 0 0 0 0 0 0 0 0 0 0 0
0 0 0 0 0 2 2 2 2 2 0 0 0 0 0 0
0 0 0 0 0 2 1 1 1 2 2 2 2 0 0 0
0 0 0 0 2 2 1 2 3 1 1 1 2 0 0 0
0 0 0 0 2 1 3 1 1 3 3 1 2 0 0 0
0 0 0 0 2 1 2 3 2 4 6 4 2 0 0 0
0 0 0 0 2 1 1 1 5 4 4 4 2 0 0 0
0 0 0 0 2 2 2 2 2 2 2 2 2 0 0 0
0 0 0 0 0 0 0 0 0 0 0 0 0 0 0 0
0 0 0 0 0 0 0 0 0 0 0 0 0 0 0 0
0 0 0 0 0 0 0 0 0 0 0 0 0 0 0 0
0 0 0 0 0 0 0 0 0 0 0 0 0 0 0 0
0 0 0 0 0 0 0 0 0 0 0 0 0 0 0 0
