0 0 0 0 0 0 0 0 0 0 0 0 0 0 0 0
0 0 0 0 0 0 0 0 0 0 0 0 0 0 0 0
0 0 0 0 0 0 0 0 0 0 0 0 0 0 0 0
0 0 0 0 2 2 2 2 2 2 2 2 2 0 0 0
0 0 0 0 2 1 1 1 2 1 1 1 2 0 0 0
0 0 0 0 2 1 3 3 3 3 3 1 2 0 0 0
0 0 0 2 2 1 3 1 3 1 3 1 2 0 0 0
0 0 0 2 1 3 1 1 5 1 1 1 2 0 0 0
0 0 0 2 1 3 1 2 2 2 2 1 2 2 0 0
0 0 0 2 1 1 2 4 4 4 4 4 1 2 0 0
0 0 0 2 2 1 1 4 4 4 4 4 1 2 0 0
0 0 0 0 2 2 2 2 2 2 2 2 2 2 0 0
0 0 0 0 0 0 0 0 0 0 0 0 0 0 0 0
0 0 0 0 0 0 0 0 0 0 0 0 0 0 0 0
0 0 0 0 0 0 0 0 0 0 0 0 0 0 0 0
0 0 0 0 0 0 0 0 0 0 0 0 0 0 0 0
