0 0 0 0 0 0 0 0 0 0 0 0 0 0 0 0
0 0 0 0 0 0 0 0 0 0 0 0 0 0 0 0
0 0 0 0 0 0 0 0 0 0 0 0 0 0 0 0
0 0 0 0 0 0 0 0 0 0 0 0 0 0 0 0
0 0 0 0 0 0 2 2 2 2 2 0 0 0 0 0
0 0 0 0 2 2 2 1 1 5 2 0 0 0 0 0
0 0 0 0 2 1 1 3 4 1 2 2 0 0 0 0
0 0 0 0 2 1 1 4 3 4 1 2 0 0 0 0
0 0 0 0 2 2 2 1 6 3 1 2 0 0 0 0
0 0 0 0 0 0 2 1 1 1 2 2 0 0 0 0
0 0 0 0 0 0 2 2 2 2 2 0 0 0 0 0
0 0 0 0 0 0 0 0 0 0 0 0 0 0 0 0
0 0 0 0 0 0 0 0 0 0 0 0 0 0 0 0
0 0 0 0 0 0 0 0 0 0 0 0 0 0 0 0
0 0 0 0 0 0 0 0 0 0 0 0 0 0 0 0
0 0 0 0 0 0 0 0 0 0 0 0 0 0 0 0
