0 0 0 0 0 0 0 0 0 0 0 0 0 0 0 0
0 0 0 0 0 0 0 0 0 0 0 0 0 0 0 0
0 0 0 0 0 0 0 0 0 0 0 0 0 0 0 0
0 0 0 0 0 0 0 0 0 0 0 0 0 0 0 0
0 0 0 0 0 0 2 2 2 0 0 0 0 0 0 0
0 0 0 0 0 0 2 4 2 0 0 0 0 0 0 0
0 0 0 0 0 0 2 1 2 2 2 2 0 0 0 0
0 0 0 0 2 2 2 3 5 3 4 2 0 0 0 0
0 0 0 0 2 4 1 3 1 2 2 2 0 0 0 0
0 0 0 0 2 2 2 2 3 2 0 0 0 0 0 0
0 0 0 0 0 0 0 2 4 2 0 0 0 0 0 0
0 0 0 0 0 0 0 2 2 2 0 0 0 0 0 0
0 0 0 0 0 0 0 0 0 0 0 0 0 0 0 0
0 0 0 0 0 0 0 0 0 0 0 0 0 0 0 0
0 0 0 0 0 0 0 0 0 0 0 0 0 0 0 0
0 0 0 0 0 0 0 0 0 0 0 0 0 0 0 0
