0 0 0 0 0 0 0 0 0 0 0 0 0 0 0 0
0 0 0 0 0 0 0 0 0 0 0 0 0 0 0 0
0 0 0 0 0 0 0 0 0 0 0 0 0 0 0 0
0 0 0 0 0 0 2 2 2 2 2 0 0 0 0 0
0 0 0 0 0 0 2 1 5 1 2 0 0 0 0 0
0 0 0 0 0 0 2 1 3 1 2 0 0 0 0 0
0 0 0 0 0 0 2 3 4 3 2 0 0 0 0 0
0 0 0 0 2 2 2 4 3 4 2 2 0 0 0 0
0 0 0 2 2 1 4 3 4 3 4 2 2 2 0 0
0 0 0 2 1 1 3 4 3 4 3 1 1 2 0 0
0 0 0 2 1 1 1 1 4 1 1 1 1 2 0 0
0 0 0 2 2 2 2 2 2 2 2 2 2 2 0 0
0 0 0 0 0 0 0 0 0 0 0 0 0 0 0 0
0 0 0 0 0 0 0 0 0 0 0 0 0 0 0 0
0 0 0 0 0 0 0 0 0 0 0 0 0 0 0 0
0 0 0 0 0 0 0 0 0 0 0 0 0 0 0 0
