0 0 0 0 0 0 0 0 0 0 0 0 0 0 0 0
0 0 0 0 0 0 0 0 0 0 0 0 0 0 0 0
0 0 0 0 0 0 0 0 0 0 0 0 0 0 0 0
0 0 0 0 0 0 0 2 2 2 2 2 0 0 0 0
0 0 2 2 2 2 0 2 1 1 1 2 2 0 0 0
0 0 2 1 1 2 2 2 1 2 1 1 2 0 0 0
0 0 2 1 3 1 4 4 4 4 2 1 2 2 0 0
0 0 2 1 1 2 2 4 4 6 4 1 1 2 0 0
0 0 2 1 1 1 1 3 2 2 3 2 1 2 0 0
0 0 2 1 3 2 3 1 1 1 3 1 1 2 0 0
0 0 2 2 1 5 1 2 2 2 3 2 1 2 0 0
0 0 0 2 2 2 2 2 0 2 1 1 1 2 0 0
0 0 0 0 0 0 0 0 0 2 2 2 2 2 0 0
0 0 0 0 0 0 0 0 0 0 0 0 0 0 0 0
0 0 0 0 0 0 0 0 0 0 0 0 0 0 0 0
0 0 0 0 0 0 0 0 0 0 0 0 0 0 0 0
