0 0 0 0 0 0 0 0 0 0 0 0 0 0 0 0
0 0 0 0 0 0 0 0 0 0 0 0 0 0 0 0
0 0 0 0 0 0 0 0 0 0 0 0 0 0 0 0
0 0 0 0 0 2 2 2 2 2 0 0 0 0 0 0
0 0 0 2 2 2 1 1 1 2 2 2 0 0 0 0
0 0 2 2 1 1 5 3 1 3 1 2 0 0 0 0
0 0 2 1 1 2 2 1 2 2 1 2 2 0 0 0
0 0 2 1 3 4 2 4 3 1 1 1 2 0 0 0
0 0 2 1 2 4 2 6 2 1 1 1 2 0 0 0
0 0 2 1 3 4 4 4 1 1 2 2 2 0 0 0
0 0 2 2 2 3 2 1 2 2 2 0 0 0 0 0
0 0 0 0 2 1 1 1 2 0 0 0 0 0 0 0
0 0 0 0 2 2 2 2 2 0 0 0 0 0 0 0
0 0 0 0 0 0 0 0 0 0 0 0 0 0 0 0
0 0 0 0 0 0 0 0 0 0 0 0 0 0 0 0
0 0 0 0 0 0 0 0 0 0 0 0 0 0 0 0
